T..=......
...=......
.../......
====......
..........
-/--------
..........
..........
........A.
..........